16 16 16 16 16 16 17 03 03 03 03 03 03 03 03 03 03 03 03 03 03 12 13 13 13
16 16 16 16 16 16 17 03 03 03 03 03 03 03 03 03 03 03 03 03 03 03 01 01 01
16 16 16 16 16 16 17 03 03 03 03 03 03 03 03 03 03 03 03 03 03 03 03 03 24
16 16 16 16 16 16 17 03 03 03 03 03 03 03 03 03 03 03 03 03 03 03 03 03 03
16 16 16 16 16 16 17 03 03 03 03 03 03 03 03 21 21 03 03 05 06 06 06 06 06
16 16 16 16 16 16 17 03 03 03 03 03 03 03 12 13 13 10 03 15 16 16 16 16 16
26 26 26 26 26 26 27 03 03 03 03 03 03 03 12 13 13 10 03 15 16 16 16 16 16
03 03 03 03 03 03 03 03 03 03 03 03 03 03 12 13 13 10 03 25 26 26 16 16 16
03 03 03 03 03 03 03 03 03 03 03 03 03 03 12 13 13 10 03 03 03 03 25 26 26
03 03 03 03 03 03 03 03 03 03 03 03 03 03 03 02 13 10 03 03 03 03 03 03 03
03 03 03 03 05 06 06 07 03 03 03 03 03 03 03 03 01 03 03 03 03 03 03 03 03
03 03 03 03 15 16 16 17 03 03 03 03 03 03 03 03 03 03 05 06 06 06 06 06 06
03 03 03 03 25 26 26 27 03 03 03 03 03 03 03 03 03 03 15 16 16 16 16 16 16
03 03 03 03 03 03 03 03 03 03 03 03 03 03 03 03 03 03 15 16 16 16 16 16 16
03 03 03 03 03 03 03 03 03 03 03 03 03 03 03 03 03 03 15 16 16 16 16 16 16
03 03 03 03 03 03 03 03 03 03 03 03 03 03 03 03 03 03 25 26 26 26 26 26 26
03 03 03 03 03 21 21 21 21 21 21 03 03 03 03 03 03 03 03 03 03 03 03 03 24
03 03 03 03 12 13 13 13 13 13 13 20 21 21 03 03 03 03 03 03 03 03 03 03 03
03 03 03 03 12 13 13 13 13 13 13 13 13 13 10 03 03 03 03 03 03 03 03 03 03