17 17 17 17 17 17 18 03 03 03 03 03 03 03 03 03 03 03 03 03 03 13 14 14 14
17 17 17 17 17 17 18 03 03 03 03 03 03 03 03 03 03 03 03 03 03 03 02 14 14
17 17 17 17 17 17 18 03 03 03 03 03 03 03 03 03 03 03 03 03 03 03 03 01 01
17 17 17 17 17 17 18 03 03 03 03 03 03 03 03 03 03 03 03 03 03 03 03 03 03
17 17 17 17 17 17 18 03 03 03 03 03 03 03 03 22 22 03 03 05 06 06 06 06 06
17 17 17 17 17 17 18 03 03 03 03 03 03 03 13 14 14 11 03 16 17 17 17 17 17
27 27 27 27 27 27 28 03 03 03 03 03 03 03 13 14 14 11 03 16 17 17 17 17 17
03 03 03 03 03 03 03 03 03 03 03 03 03 03 13 14 14 11 03 26 27 27 17 17 17
03 03 03 03 03 03 03 03 03 03 03 03 03 03 13 14 14 11 03 03 03 03 26 27 27
03 03 03 03 03 03 03 03 03 03 03 03 03 03 03 02 14 11 03 03 03 03 03 03 03
03 03 03 03 05 06 06 07 03 03 03 03 03 03 03 03 01 03 03 03 03 03 03 03 03
03 03 03 03 16 17 17 18 03 03 03 03 03 03 03 03 03 03 05 06 06 06 06 06 06
03 03 03 03 26 27 27 28 03 03 03 03 03 03 03 03 03 03 16 17 17 17 17 17 17
03 03 03 03 03 03 03 03 03 03 03 03 03 03 03 03 03 03 16 17 17 17 17 17 17
03 03 03 03 03 03 03 03 03 03 03 03 03 03 03 03 03 03 16 17 17 17 17 17 17
03 03 03 03 03 03 03 03 03 03 03 03 03 03 03 03 03 03 26 27 27 27 27 27 27
03 03 03 03 03 22 22 22 22 22 22 03 03 03 03 03 03 03 03 03 03 03 03 03 03
03 03 03 03 13 14 14 14 14 14 14 21 22 22 03 03 03 03 03 03 03 03 03 03 03
03 03 03 03 13 14 14 14 14 14 14 14 14 14 11 03 03 03 03 03 03 03 03 03 03