04 04 04 04 04 04 04 04 04 04 04 04 04 04 04 04 04 04 04 04 04 04 04 04 03 
04 04 04 04 04 04 04 04 04 04 04 04 04 04 04 04 04 04 04 04 04 04 04 04 03 
04 04 04 04 04 04 04 04 04 04 04 04 04 04 04 04 04 04 04 04 04 04 04 04 03 
04 04 04 04 04 04 04 04 04 04 04 04 04 04 04 04 04 04 04 04 04 04 04 04 03 
17 17 17 17 17 17 17 17 17 17 17 27 27 27 27 27 27 27 27 27 27 27 27 28 03 
27 27 27 27 27 27 27 27 27 27 28 03 03 03 03 03 03 03 03 03 03 03 03 03 03 
03 03 03 03 03 03 03 03 03 03 03 03 03 03 03 03 03 03 03 03 03 03 03 03 03 
03 03 03 03 03 03 03 03 03 03 03 03 03 03 03 03 03 03 03 03 03 03 03 03 03 
03 03 03 03 03 03 03 03 03 03 03 03 03 03 03 03 03 03 05 06 06 07 03 03 03 
03 03 03 03 03 03 03 03 03 03 03 03 03 03 03 03 03 03 16 17 17 18 03 03 03 
03 03 03 03 03 03 03 03 03 03 03 03 03 03 03 03 03 03 26 27 27 28 03 03 03 
03 03 03 03 03 03 03 03 03 03 03 03 03 03 03 03 03 03 03 03 03 03 03 03 03 
03 03 03 03 03 03 03 03 03 03 03 03 03 03 03 03 03 03 03 03 03 03 03 03 03 
03 03 03 03 03 03 03 03 03 03 03 03 03 03 03 03 03 03 03 03 03 03 03 03 03 
03 03 03 03 03 03 22 22 22 22 22 22 22 22 22 22 22 22 22 22 03 03 03 03 03 
03 03 03 03 03 13 14 14 14 14 14 14 14 14 14 14 14 14 14 14 11 03 03 03 03 
22 22 22 22 22 23 14 14 14 14 14 14 14 14 14 14 14 14 14 14 11 03 03 03 03 
14 14 14 14 14 14 14 14 14 14 14 14 14 14 14 14 14 14 14 14 21 22 22 22 22 
14 14 14 14 14 14 14 14 14 14 14 14 14 14 14 14 14 14 14 14 14 14 14 14 14 